Суть проекта: построение модели предсказания стоимости автомобилей, на основании данных датасета сайта avto.ru

Краткая информация о данных
В этом проекты мы работатем с датасетом, содержащим сведения о характеристиках автомобилей, а модель, которую мы обучим, должна будет предсказывать стоимость автомобиля.

Описания полей датасета:

bodyType - тип кузова автомобиля
brand - марка (бренд) автомобиля
color - цвет автомобиля
fuelType - тип топлива
modelDate - дата выпуска модели
name - комбинация нескольких характеристик (модели, объема двигателя и привода)
numberOfDoors - кол-во дверей
productionDate - дата производства авто
vehicleConfiguration - комбинация типа трансмиссии, объема двигателя и мощности двигателя
vehicleTransmission - тип трансмиссии (коробки передач)
engineDisplacement - объем двигателя в литрах
enginePower - мощность двигателя (л.с.)
description - дополнительные характеристики по комплектации авто
mileage - пробег автомобиля (км.)
Комплектация - дополнительные характеристики по комплектации авто
Привод - характеристика привода автомобиля, которое передает энергию от двигателя на колеса.
Руль - характеристика руля по стороне расположения руля в автомобиле
Состояние - характеристика необходимости проведения ремонта
Владельцы - кол-во владельцев (3 значения: 1 владелец, 2 владельца, 3 и более)
ПТС - тип ПТС (паспорт технического средства)
Таможня - информация о том расстаможен автомобиль или нет (2 значения - Растаможен, Не ратаможен)
Владение - срок владения автомобилем в годах и месяцах
price - цена указанная в объявлении на авто.ру
start_date - дата размещения объявления на авто.ру
hidden - характеристика объявления на авто.ру
model - название модели автомобиля
id - - сервисный для генерации submition

Этапы работы над проектом:

Импорт библиотек, данных;
Первичная обработка датасетов;
Обработка данных перед слиянием;
Предварительный анализ данных;
Детальный анализ переменных:
Подготовка данных к машинному обучению
добалвение dummy-переменных;
Преобразование переменных;
Обучение моделей;
Итоговые расчеты.